000000000000011111111110011111111110011110000000010002000040010002111110010200111110011100000030011100000030011102000030011100000030000000000000
000000000000011111111110011100011110011000010010011110000310011110111310011020111310011022111110011400111110011111111110011111111110000000000000
000000000000011111111110011111111110011110011110011104211110011102011110011100201110011132001110011133131110011111111110011111111110000000000000
000000000000011114000000011100011000000101011010030002001210030101000000011100011200011110111000011130000000011111111110011111111110000000000000
000000000000011111130030011111022010033114001010000110001010000110201010002000200010000011111000000110011000000110000000000113111110000000000000
000000000000030111000110030111020110000111020110000004021110000111020010011100000110011102000110030001110110000000110110000003113110000000000000
000000000000011111100110010000100110010110100110010110123110010000023110010110123110010110100110010000140110011111100110011111100110000000000000
